19 19
17 0
11 18
*******************
* *               *
* * *** * *********
*   *   *         *
* *** ********* * *
* *   *       * * *
* ***** ***** *** *
*   *       * *   *
*** * ***** * * * *
*   * *   * * * * *
*** * * * * * * * *
*   *   * * *   *  
* ******* ******* *
*       * *       *
***** * * * ***** *
*   * * *   *   * *
* *** * ***** * * *
      *       *   *
*******************
